
NO ./assets/wall_no.xpm
SO ./assets/wall_so.xpm
WE ./assets/WALLIOYFAGYGAFUYGAFIUGYAIUFIUAGYFIU.xpm
EA ./assets/wall_ea.xpm

F 10,10,10
C 10,10,10

     1111111111111111111111111
     1000000000110000000000001
     1011000001110000000000001
     1001000000000000000000001
111111111011000001110000000000001
100000000011000001110111111111111
11110111111111011100000010001
11110111111111011101010010001
11000000110101011100000010001
10000000000000000000000010001
1000000000000000110101000001
11011111101010111111111000111
1111111 1110101 101011010S01
11111111 1111111 111111111111