NO ./assets/kidding/wall_no.xpm
SO ./assets/kidding/wall_so.xpm
WE ./assets/kidding/wall_we.xpm
EA ./assets/kidding/wall_ea.xpm

F 98,70,33
C 180,225,231

1111111111111111111111111111111111
1000001000000100000000000001001111
1110101111110101111111111111111111
1000100000000101000000000001111111
101111111111110S011111111100110001
1000000000000001000000000001111101
1111111111111111111111111111111111
