
NO ./assets/WALL.xpm
SO ./assets/WALL.xpm
WE ./assets/WALL.xpm
EA ./assets/WALL.xpm

F 10,10,10
C 10,10,10

1111111111111111111111111111111111
10000000000000000000000000000001001111
1000000000000001111111111
1000000000000000000000000000111001111
100000000000000S00000000000100001
100000000000000000000000000011101
11111111111110011111111111111111