
NO ./assets/BOOKS.xpm
SO ./assets/WALL.xpm
WE ./assets/WALL.xpm
EA ./assets/WALL.xpm

F 75,186,-55
C 77,159,240

111111111111111111111111111111
100000000000000010000000000001
111111111111110010000000000001
100000000000000000000000000001
100000000000001111111111000001
100000000000001110000000000001
111000000000001110000000000001
100000000000000000000000000001
100000000000000000000000000001
1000000000000S0000000000000001
100000000000000000000000000001
100000000000000000000000000001
100000000000000000000000000001
100011111111111111111111110001
100000000000000000000000000001
100000000000000000000000000001
111111111111111111111111111111
111111111111111111111111111111
111111111111111111111111111111





