
NO ./assets/wall_no.xpm
SO ./assets/wall_so.xpm
EA ./assets/wall_ea.xpm
WE ./assets/wall_we.xpm

C 255,100,160
F 122,122,122

11111111111111111
10000000000000001
10000000000000001
10000000000000001
10000000000000001
10000000N00000001
10001000N00010001
10000000000000001
10000000000000001
10000000000000001
10000000000000001
10000000000000001
11111111111111111
