
NO ./assets/WALL.xpm
SO ./assets/WALL.xpm
EA ./assets/WALL.xpm
WE ./assets/WALL.xpm

C 255,100,160
F 122,122,122

11111111111111110
10000000000000001
10000000000000001
10000000000000001
10000000000000001
10000000000000001
10001000N00010001
10000000000000001
10000000000000001
10000000000000001
10000000000000001
10000000000000001
11111111111111111
